

    **********
    **       **
    **       **
    **      **      
    ********
    ** **
    **  **
    **   **
    **    **

