
   **********
   **      **
   **      **
   ********
   *****
   **  **
   **   **
   **    **
   **     **